 /--------------\  /--------------------\  /--------------------\  /--------------\ 
 |  .  .  .  .  |  |  .  .  .  .  .  .  |  |  .  .  .  .  .  .  |  |  .  .  .  .  | 
 |  .  /--\  .  |  |  .  /--------\  .  |  |  .  /--------\  .  |  |  .  /--\  .  | 
 |  *  |  |  .  \--/  .  \-----\  |  .  |  |  .  |  /-----/  .  \--/  .  |  |  *  | 
 |  .  |  |  .  .  .  .  .  .  |  |  .  \--/     |  |  .  .  .  .  .  .  |  |  .  | 
 |  .  |  \-----\  .  /--\  .  |  |  .  .  .  .  |  |  .  /--\  .  /-----/  |  .  | 
 |  .  |  /-----/  .  |  |  .  |  |  .  /--\  .  |  |  .  |  |  .  \-----\  |  .  | 
 |  .  \--/  .     .  |  |  .  \--/  .  |  |  .  \--/  .  |  |  .  .  .  \--/  .  | 
 |  .  .  .  .  .  .  |  |  .  .  .  .  |  |  .  .  .  .  |  |  .  /--\  .  .  .  | 
 \--------------\  .  |  \--------\  .  |  |  .  /--------/  |  .  |  \-----------/ 
############### |  .  \-----------/  .  \--/  .  \-----------/  .  | ###############
############### |  .                                            .  | ###############
############### |  .  /--\     /-------      -------\     /--\  .  | ###############
----------------/  .  |  |     |                    |     |  |  .  \----------------
 A                 .  |  |     |                    |     |  |  .                 B 
----------------\  .  |  |     |                    |     |  |  .  /----------------
############### |  .  \--/     \--------------------/     \--/  .  | ###############
############### |  .  .  .                                .  .  .  | ###############
############### \--------\  .  /--------------------\  .  /--------/ ###############
 /--------------------\  |  .  \--------\  /--------/  .  |  /--------------------\ 
 |  .  .  .  .  .  .  |  |  .  .  .  .  |  |  .  .  .  .  |  |  .  .  .  .  .  .  | 
 |  .  /--------\  .  |  \--------\  .  |  |  .  /--------/  |  .  /--------\  .  | 
 |  *  \--------/  .  \-----------/  .  \--/  .  \-----------/  .  \--------/  *  | 
 |  .  .  .  .     .  .  .  .  .  .  .  .  .  .  .  .  .  .  .  .  .  .  .  .  .  | 
 |  .  /--------\  .  /--\  .  /--------------------\  .  /--\  .  /--------\  .  | 
 |  .  |  /-----/  .  |  |  .  \--------\  /--------/  .  |  |  .  \-----\  |  .  | 
 |  .  |  |  .  .  .  |  |  .  .  .  .  |  |  .  .  .  .  |  |  .  .  .  |  |  .  | 
 |  .  |  |  .  /-----/  \--------\  .  |  |  .  /--------/  \-----\  .  |  |  .  | 
 |  .  \--/     \-----------------/  .  \--/  .  \-----------------/  .  \--/  .  | 
 |  .  .  .  .  .  .  .  .  .  .  .  .  .  .  .  .  .  .  .  .  .  .  .  .  .  .  | 
 \--------------------------------------------------------------------------------/ 
