 /--------------------------------------\  /--------------------------------------\ 
 |  .  .  .  .  .  .  .  .  .  .  .  .  |  |  .  .  .  .  .  .  .  .  .  .  .  .  | 
 |  .  /--------\  .  /-----------\  .  |  |  .  /-----------\  .  /--------\  .  | 
 |  *  | ###### |  .  | ######### |  .  |  |  .  | ######### |  .  | ###### |  *  | 
 |  .  \--------/  .  \-----------/  .  \--/     \-----------/  .  \--------/  .  | 
 |  .  .  .  .  .  .  .  .  .  .  .  .  .  .  .  .  .  .  .  .  .  .  .  .  .  .  | 
 |  .  /--------\  .  /--\  .  /--------------------\  .  /--\  .  /--------\  .  | 
 |  .  \--------/  .  |  |  .  \--------\  /--------/  .  |  |  .  \--------/  .  | 
 |  .  .  .  .  .  .  |  |  .  .  .  .  |  |  .  .  .  .  |  |  .  .  .  .  .  .  | 
 \--------------\  .  |  \--------\  .  |  |  .  /--------/  |  .  /--------------/ 
############### |  .  |  /--------/  .  \--/  .  \--------\  |  .  | ###############
############### |  .  |  |                                |  |  .  | ###############
############### |  .  |  |     /-------      -------\     |  |  .  | ###############
----------------/  .  \--/     |                    |     \--/  .  \----------------
 A                 .           |                    |           .                 B 
----------------\  .  /--\     |                    |     /--\  .  /----------------
############### |  .  |  |     \--------------------/     |  |  .  | ###############
############### |  .  |  |                                |  |  .  | ###############
############### |  .  |  |     /--------------------\     |  |  .  | ###############
 /--------------/  .  \--/     \--------\  /--------/     \--/  .  \--------------\ 
 |  .  .  .  .  .  .  .  .  .  .  .  .  |  |  .  .  .  .  .  .  .  .  .  .  .  .  | 
 |  .  /--------\  .  /-----------\  .  |  |  .  /-----------\  .  /--------\  .  | 
 |  *  \-----\  |  .  \-----------/  .  \--/  .  \-----------/  .  |  /-----/  *  | 
 |  .  .  .  |  |  .  .  .  .  .  .  .  .  .  .  .  .  .  .  .  .  |  |  .  .  .  | 
 \-----\  .  |  |  .  /--\  .  /--------------------\  .  /--\  .  |  |  .  /-----/ 
 /-----/  .  \--/  .  |  |  .  \--------\  /--------/  .  |  |  .  \--/  .  \-----\ 
 |  .  .  .  .  .  .  |  |  .  .  .  .  |  |  .  .  .  .  |  |  .  .  .  .  .  .  | 
 |  .  /--------------/  \--------\  .  |  |  .  /--------/  \--------------\  .  | 
 |  .  \--------------------------/  .  \--/  .  \--------------------------/  .  | 
 |  .  .  .  .  .  .  .  .  .  .  .  .  .  .  .  .  .  .  .  .  .  .  .  .  .  .  | 
 \--------------------------------------------------------------------------------/ 
